DE0005501357
DE0005408116
DE000A1EWWW0
DE0005103006
NL0000235190
DE000A0WMPJ6
DE0008404005
DE0006766504
DE000BASF111
DE0005190003
DE000BAY0017
CH0038389992
DE0005158703
DE0005200000
DE0005909006
DE000A1DAHH0
DE0005419105
DE0005313704
DE000CLS1001
DE000CBK1001
DE0005437305
DE0005439004
DE0007100000
DE0005140008
DE0005810055
DE0007480204
DE0005552004
DE000A0HN5C6
GB0059822006
DE0005878003
DE0005550636
DE0005545503
DE0005557508
DE0005565204
DE000ENAG999
DE0007856023
DE000EVNK013
DE0005664809
DE0005772206
DE0005773303
DE000A0Z2ZZ5
DE0005785802
DE0005785604
DE0005790430
LU0269583422
DE0006602006
DE000A0LD6E6
DE0003304101
DE0008402215
DE0006047004
DE0006048432
DE0006070006
DE000A1PHFF7
DE0006231004
DE0006229107
DE000KSAG888
DE000KD88880
DE000KC01000
DE0006053952
DE0006335003
DE0006204407
DE0005470405
DE000LEG1110
DE0005408884
DE0006483001
DE0006450000
DE0008232125
DE0005937007
DE0006599905
DE0007257503
DE0006632003
DE000A0D9PT0
DE0008430026
DE0006452907
DE000A0D6554
DE000A1H8BV3
DE000LED4000
DE0006916604
DE000PSM7770
DE000A0Z1JH9
NL0000240000
DE0005137004
DE0007010803
DE0007030009
DE0007042301
LU0061462528
DE0007037129
DE0006202005
DE0007164600
DE0007165631
DE0007235301
DE0007236101
DE000SKYD000
DE000A0DJ6J9
DE0003304002
DE0007251803
DE0007289001
DE0007297004
DE000SYM9999
DE0008303504
DE000TLX1005
DE000A1J5RX9
DE0007500001
DE000TUAG000
DE0005089031
DE0007664039
DE000WCH8881
DE000A0CAYB2
DE0007472060
DE000XNG8888
